11111111111111111
10C00000C00000001
1C000000000000001
1000000000E000001
1P00000000000C001
10000000000000001
1P00000000000C001
1P00000000000C001
11111111111111111