111111111111111111111111111
100000000010C010000C0011111
1000000001001110000000P1111
100000000001000C00011101111
100000000001111110000000001
1000C0000000000000000C00001
111111111111111111111111111