11111111111111111
10C10011C00000001
1C100111111000011
100001001E1000011
1010000010000C001
11100010000000111
1C00001000001C001
1000001000001C001
11111111111111111