11111111111111111111111111111111111
1E00100000000000C00000C000000000001
10101010100100000101001000000010101
10101010010101010001001000000010101
1P0010000PC00C0000000000000000000C1
11111111111111111111111111111111111