1111111111111111111111
1000000000000000111111
100000000000C000111111
1001001111100P00111111
1000000000000000111111
1111111111111111111111